++++++++++++++++++++++++++++++++++++++++++++++++++++++++++++++++++++++++++++++++
++++          ++++++++++++++++++++++ ++++++++++++++++++++++++        ++++ ++++++
+S   ++ +++ ++++++++++++++++++++++++ ++++ +++++++++++++++++++ +++ +++++++ ++++++
++++ ++     +++++++++++++++++++ ++++ ++++                 +++ +++ +++++++ ++++++
++++ ++ ++ ++++++++       +++++ ++++ ++++ +++++++++++++++++++ +++         ++++++
++   +++++ ++++++++ +++++ +++++           ++++ ++++++++++++++ ++++++++ +++++++++
++++++++++ ++++++++ +++++ +++++ +++++ ++++++++ +++              ++++++ +++++++++
++++++++++ +        +++++       +++++ ++++++++ +++ ++++++++ +++ ++++++ +++++++++
++++++++++   ++++++++++++ +++++ +++++ +++++++++    ++++++++++++ ++++++ +++++++++
+++++++++++++++++++++++++       ++++++++++++++++++       ++++++        +++++++++
+++++++ +++++++++++++++++++++++ ++++++      ++++++ +++++ ++++++ ++++++++++++++++
+++++++ +++++++++++++++++++++++ ++++++ ++++ ++++++ +++++ ++++++ ++++++++++++++++
++      ++++++++++              ++++++ ++++ ++++++ +++++ ++++++        +++++++++
+++++++ ++++++++++ +++++++++++++++++++ ++++        +++++++++++++ +++++ +++++++++
+++++++            +++++               +++++++ +++++++           ++    +++++++++
++++++++++++++++++       +++++++++++++++++++++ ++++++++++++++++++++G++++++++++++
++++++++++++++++++++++++++++++++++++++++++++++++++++++++++++++++++++++++++++++++