++++++++++
+     G+ +
+    +++ +
+        +
+++++    +
+   +    +
+S       +
++++++++++