++++++++++++
+     +G   +
+ ++++++   +
+          +
+++++   ++ +
+       +  +
+S   +     +
++++++++++++